Frogger	frog	
Sssss	snake	0
Viperi	snake	
Boa	snake	
Ssslitherin	snake	
Hisssus	snake	
Fangtastic	snake	
Linussss	snake	
Delphiss	snake	
Elvisss	snake	
Csssera	snake	
Yuliusss	snake	
Daisssy	snake	
Erysss	snake	
Sssoma	snake	
Hhhemi	snake	
Sssiri	snake	
Lachesisss	snake	
Liasss	snake	
Pelisss	snake	
Phholia	snake	
Calisssto	snake	
Candisss	snake	
Lyssstro	snake	
Agnusss	snake	
Denissson	snake	
Latrisss	snake	
Rossse	snake	
Nira	frog	
Percy	frog	
Garen	frog	
Marjorie	frog	
Rana	frog	
Amura	frog	
Arvalis	frog	
Attica	frog	
Aurora	frog	
Boyli	frog	
Cascada	frog	
Chao	frog	
Hensin	frog	
Chev	frog	
Corey	frog	
Dalma/ Tina	frog	
Rayton	frog	
Rae/Ray	frog	
Han-Lu	frog	
John	frog	
Ryukyu	frog	
Lataste	frog	
Taipa	frog	
Luan-Chuan	frog	
Nemi	frog	
Neba	frog	
Omei	frog	
Nikk≈ç	frog	
Piri	frog	
Tio	frog	
Mat	frog	
Sakurai	frog	
Teri	frog	
Sierra	frog	
Tago	frog	
Tavas	frog	
Tsushima	frog	
Uenoi	frog	
Ulma	frog	
Lith	frog	
Meri	frog	
Abba	frog	
Pulchrie	frog	
Sanguira	frog	
Tauro	frog	
Sumatera	frog	
Sylvirana	frog	
Attigua	frog	
Celebensis	frog	
Chitwanensis	frog	
Lateralis	frog	
Latouchie	frog	
Monty	frog	
Dybowskii	frog	
Norris	frog	